5 7
#####
# . #
#.S.#
#. .#
#  .#
# E #
#####
